border_size=1
usage=map

Gll^Fp, Gg, Gll^Fp, Gg, Gg, Gg^Gvs, Gg^Gvs, Gg, Gg^Gvs, Gg^Gvs, Gg^Gvs, Gg^Gvs, Gg^Gvs, Gg^Gvs, Gg^Gvs, Gg, Qlf, Wo, Wo, Gg, Ch, Gg, Ch, Gg, Wo, Wo, Qlf, Dd, Dd, Dd, Dd, Dd, Dd, Dd, Dd^Br|, Dd, Dd, Dd, Dd^Dc, Dd, Cd, Dd, Cd, Dd, Dd^Dc, Dd
Gg, Gg^Fet, Gll^Fp, Gll^Ftr, Gg^Fet, Gs^Fds, Gg^Gvs, Gg^Gvs, Gg^Gvs, Gg^Gvs, Gg^Gvs, Gg^Gvs, Gg^Gvs, Gg^Gvs, Gg, Gg, Ql, Wo, Wo, Co, Kd^Bw|, Ke, Kd^Bw|, Co, Wo, Wo, Ql, Dd, Dd, Dd, Xol, Dd, Dd, Dd^Do, Dd^Br|, Dd, Dd, Dd, Dd^Dc, Cd, Cd, Cd, Cd, Cd, Dd^Dc, Dd
Gg, Gg^Fet, Gll^Ftr, Gll^Fp, Gll^Fp, Gs^Ftp, Gg^Gvs, Gg^Gvs, Gg^Gvs, Gg^Gvs, Gg^Gvs, Gg^Gvs, Gg, Gg^Efm, Gs, Gg, Ql, Wo, Kv, Co, Wo, Ket, Wo, Co, Kv, Wo, Ql, Dd, Dd, Xol, Xol, Xol, Dd, Dd, Dd^Br|, Dd, Ds, Ds, Dd^Dc, Cd, Cd, Cd, Cd, Cd, Dd^Dc, Dd
Gg, Gll^Fp, Gs^Fds, Gg^Fet, Gs^Fds, Gs^Fds, Gg^Gvs, Gg^Gvs, Gg^Gvs, Gg^Gvs, Gg, Gg, Gg, Gg, Gg, Gg, Qlf, Wo, Wo, Wo, Wo, Kv, Wo, Wo, Wo, Wo, Qlf, Dd, Dd, Xol, Xol, Xol, Dd, Dd, Dd^Br|, Dd, Ds, Dd, Dd, Dd^Dc, Dd^Dc, Cd, Dd^Dc, Dd^Dc, Dd, Dd
Gs^Fds, Gs^Fds, Gs^Fds, Gs^Ftp, Gg^Fet, Gg^Gvs, Gg^Gvs, Gg^Gvs, Gg, Gg, Gg, Gg, Gg^Efm, Gg, Gg, Gg, Gg, Qlf, Qlf, Wo, Wo, Qxu^Bh\, Qxu^Bh\, Wo, Qlf, Qlf, Dd, Dd, Dd, Xol, Xol, Xol, Dd, Dd, Dd^Br|, Dd, Ds, Dd, Dd, Dd, Dd, Dd^Dc, Dd, Dd, Dd^Do, Dd
Gs^Fds, Gg^Fet, Gs^Fds, Gs^Efm, Gg, Gg^Gvs, Gg^Efm, Gg, Gg, Gg, Qlf, Gg, Gg, Gg, Gg, Gg, Gg, Gg, Gg, Qlf, Xol, Xol, Gg, Qxu^Bh\, Gg, Dd, Dd, Dd, Dd, Dd, Dd, Dd, Dd, Dd, Dd^Br|, Dd, Dd, Dd, Dd, Dd, Dd, Dd, Ds, Ds, Dd^Do, Dd
Gg^Efm, Gs^Fds, Gg, Gg^Efm, Gg, Gg, Gg, Gg, Gg, Gg, Gs, Gg, Gg, Gg, Gs, Gs, Gs, Gg, Gg, Gg, Gg, Gg, Gg, Gg, Ket, Ket, Ket, Dd, Dd^Esd, Dd, Dd^Esd, Dd, Dd, Dd, Dd^Br|, Dd, Dd, Dd, Ds, Dd, Dd, Ds, Dd, Dd, Dd, Dd
Gg^Efm, Gg, Qlf, Gg, Gg, Qlf, Gg, Qlf, Gg, Gg, Gg, Gg, Qlf, Gg, Gg, Gs, Gs, Gs, Gg, Gg, Gg, Gg, Gg, Dd, Ce, Ket, Ce, Dd, Dd^Esd, Ds, Ds, Dd^Esd, Dd^Esd, Rr^Vhc, Dd^Br|, Rr^Vhc, Dd, Ds, Ds, Ds, Ds, Dd, Dd, Dd, Hd, Dd
Gg, Gg, Gg, Gg^Efm, Gg, Gg, Gg, Gg, Qlf, Gg, Qlf, Gg, Gg, Gg, Gg, Gs, Gs, Gs, Gs^Fms, Gs^Fms, Gs^Fms, Gg, Gs^Fms, Gs^Fms, Gs^Fms, Ce, Dd, Dd, Dd^Esd, Ds, Dd^Esd, Dd^Esd, Dd^Esd, Rr^Vhc, Cea, Rr^Vhc, Dd, Ds, Ds, Ds, Dd, Ds, Dd, Hd, Hd, Hd
Gg, Gg, Qlf, Gg, Qlf, Gg, Qlf, Qlf, Qlf, Qlf, Qlf, Gg, Gg, Qlf, Qlf, Gg, Gg, Gs^Fms, Gs^Fms, Gs^Fms, Gs^Fms, Gs^Fms, Gs^Fms, Gs^Fms, Gs^Fms, Gs^Fms, Dd, Dd, Dd^Esd, Dd^Esd, Dd^Esd, Dd^Edpp, Dd^Esd, Dd^Esd, Dd^Edpp, Dd^Esd, Dd^Esd, Ds, Dd^Esd, Ds, Dd, Ds, Dd, Hd, Hd, Dd
Qlf, Qlf, Qlf, Qlf, Ql, Qlf, Qlf, Qlf, Qlf, Qlf, Qlf, Qlf, Qlf, Gg, Gg, Qlf, Gg, Gs^Fms, Gs^Fms, Gs^Fms, Gs^Fms, Gs^Fms, Gs^Fms, Gs^Fms, Gs^Fms, Gs^Fms, Dd, Dd, Dd^Edpp, Dd^Edpp, Dd^Edpp, Dd^Edpp, Dd^Edpp, Dd^Esd, Dd^Esd, Dd^Esd, Dd^Esd, Dd^Esd, Dd^Esd, Ds, Dd, Dd, Ds, Hd, Dd, Dd
Qlf, Qlf, Ql, Ql, Mv, Ql, Ql, Qlf, Qlf, Qlf, Qlf, Qlf, Qlf, Qlf, Gg, Gg, Gg, Gs^Fms, Gs^Fms, Gs^Fms, Gs^Fms, Gs^Fms, Gs^Fms, Gs^Fms, Dd, Dd, Dd, Dd, Dd^Edpp, Dd^Edpp, Dd^Edpp, Dd^Edpp, Dd^Edpp, Dd^Esd, Dd^Esd, Dd^Edpp, Dd, Dd^Esd, Dd^Esd, Dd^Esd, Dd^Esd, Ds, Dd, Dd, Dd, Dd
Qlf, Qlf, Ql, Mv, Mv, Mv, Qlf, Qlf, Qlf, Qlf, Qlf, Qlf, Qlf, Gg, Gg, Gg, Qlf, Gg, Gd, Gs^Fms, Gd, Gd, Gd, Gs^Fms, Gd, Dd, Dd, Dd, Dd^Edpp, Dd^Edpp, Dd^Edpp, Dd^Edpp, Dd^Edpp, Dd^Edpp, Dd^Edpp, Dd^Esd, Dd^Esd, Dd^Esd, Dd^Do, Dd^Esd, Dd^Esd, Dd^Esd, Dd^Esd, Dd, Dd, Dd
Qlf, Qlf, Qlf, Ql, Ql, Ql, Qlf, Qlf, Qlf, Qlf, Qlf, Qlf, Qlf, Qlf, Gg, Gg, Qlf, Gd, Gd, Qlf, Gd, Gd, Gd, Gd, Gs^Vh, Gd, Gs^Vht, Dd, Dd^Edpp, Dd^Edpp, Dd^Edpp, Dd^Edpp, Dd^Esd, Dd^Esd, Dd^Esd, Dd^Esd, Dd^Esd, Dd^Esd, Dd^Esd, Dd^Esd, Dd^Esd, Dd^Esd, Dd, Dd, Dd^Edpp, Dd^Edpp
Qlf, Qlf, Qlf, Qlf, Qlf, Qlf, Qlf, Qlf, Qlf, Qlf, Qlf, Qlf, Qlf, Qlf, Qlf, Gg, Gs, Gs, Gs, Gd, Gd, Gd, Re^Vct, Gg, Gg, Gs^Vc, Gd, Gd, Dd^Edpp, Dd^Edpp, Gd, Dd^Esd, Dd, Dd^Esd, Dd^Esd, Dd^Esd, Dd^Esd, Dd^Esd, Dd, Dd^Esd, Dd, Dd^Esd, Dd, Dd^Do, Dd^Edpp, Dd^Edpp
Gg, Qlf, Qlf, Qlf, Gg, Qlf, Qlf, Qlf, Qlf, Qlf, Qlf, Qlf, Qlf, Qlf, Gs, Gs, Qlf, Gs, Gll, Gs, Gs, Gs^Vh, Gg, Gs^Vc, Gg^Vwm, Re^Vct, Gs^Vh, Gd, Gd, Gs, Gd, Dd, Dd, Dd, Ds, Ds, Dd, Dd, Dd, Dd, Dd, Dd, Dd, Dd, Dd, Dd
Gg, Qlf, Gg, Gg, Gg, Gg, Gg, Gg, Gg, Gg, Gg, Gg, Gg, Gg, Gs, Gs, Gg, Gg, Gll, Gll, Gg, Gs, Gs, Hh^Vhh, Re^Vct, Gg, Gg^Ve, Gs, Gd, Gd, Gd, Gd, Dd, Dd, Dd, Ds, Ds, Ds, Ds, Dd, Dd, Dd, Dd, Dd, Dd, Dd
Gg, Gg, Gg, Gg, Gg^Eff, Qlf, Qlf, Gg, Gg, Qlf, Gg, Gg, Gg, Qlf, Gs, Gll, Gll, Gll, Gll, Gll, Gll, Gs, Gs, Gs, Gg, Gg, Gg, Gs, Gs, Gd, Dd^Vda, Dd, Uh, Dd, Dd, Ds, Dd, Dd, Dd, Dd, Dd, Dd, Dd, Dd, Dd, Dd
Gg, Gg^Eff, Gg^Eff, Aa^Eff, Gg, Gg^Eff, Aa^Eff, Gg, Aa^Eff, Aa^Eff, Aa^Eff, Gg, Gg, Gg, Gs, Gg, Aa, Aa, Aa, Gll, Gg, Gg, Gg, Gs^Vh, Gg, Re^Vct, Gg, Gg, Dd^Vda, Dd^Vda, Xuce, Dd^Vda, Dd^Vda, Dd, Qxua, Qxua, Qxua, Qxua, Qxua, Qxua, Qxua, Qxua, Qxua, Qxua, Qxua, Dd
Gg, Aa, Aa, Rrc^Vhca, Aa, Gg, Aa, Gg, Aa, Aa, Aa^Vla, Aa^Eff, Gg^Eff, Aa, Aa, Aa, Aa, Aa, Aa, Gll, Gg, Ss, Gg, Gg, Gg, Gg, Gs, Gg, Dd^Vda, Xuce, Xuce, Xuce, Urb, Ur, Ur, Ur, Ur, Ur, Ur, Ur, Ur, Ur, Ur, Ur, Ur, Ur
Aa, Aa, Rrc, Rrc, Aa, Aa, Aa, Aa, Aa^Vea, Rrc, Aa, Aa, Aa^Eff, Aa^Eff, Rrc, Aa, Aa, Aa, Ai, Aa, Aa, Gs, Gs, Gs, Gs, Gs, Gs, Gs, Dd^Vda, Xuce, Xuce, Xuce, Dd^Vda, Ur, Qxua, Ur, Qxua, Ur, Qxua, Ur, Qxua, Ur, Qxua, Ur, Qxua, Ur
Aa, Aa^Voa, Rrc, Aa^Voa, Rrc, Aa^Voa, Rrc, Rrc, Rrc, Rrc, Rrc^Vhca, Rrc^Eff, Rrc, Rrc, Aa, Rrc, Aa, Ai, Ai, Ai, Aa, Aa, Gs, Gs, Gs, Gs, Ss, Gs, Dd^Vda, Xuce, Xuce, Xuce, Uh, Rd, Rd, Qxua, Rd, Qxua, Rd, Qxua, Rd, Qxua, Rd, Qxua, Rd, Rd
Aa, Rrc, Rrc, Rrc, Rrc, Rrc, Rrc, Aa^Voa, Aa^Eff, Rrc, Rrc, Rrc, Aa^Eff, Aa^Eff, Aa, Rrc, Aa, Ai, Ai, Ai, Aa, Aa, Ss, Gs, Gs, Gs, Gs, Gs, Gg, Dd^Vda, Dd^Vda, Dd^Vda, Gs, Rd, Rd, Rd, Rd, Rd, Rd, Rd, Rd, Rd, Gd, Gd, Rd, Rd
Aa, Aa^Voa, Rrc, Aa^Voa, Rrc, Aa^Voa, Aa^Eff, Aa^Eff, Aa, Aa^Eff, Aa^Eff, Aa^Eff, Aa, Aa, Aa, Aa, Aa, Ai, Ai, Ai, Aa, Aa, Aa, Gg, Gs, Gs, Gs, Gg, Gs, Gs, Gs, Gs, Gs, Rd, Rd, Rd, Re, Re, Rd, Rd, Rd, Gd, Rd, Rd, Rd, Rd
Aa^Vea, Rrc, Rrc, Aa, Rrc^Vhca, Aa^Eff, Aa^Eff, Aa, Aa, Aa, Aa, Aa, Aa, Aa, Aa, Aa, Aa, Aa, Aa, Aa, Aa, Aa, Aa, Gs, Gs, Gs, Gs, Gs, Gs, Gs, Gg, Gs, Wo, Wwrg, Wwrg, Re, Re, Re, Re, Rd, Rp, Rd, Rp, Rd, Gd, Gd
Aa^Vea, Aa^Vea, Rrc, Aa, Aa^Eff, Aa^Eff, Aa, Aa, Aa, Aa, Ai, Ai, Ai, Aa, Aa, Aa, Aa, Aa, Aa, Aa, Aa, Aa, Gg, Gs, Gs, Gs, Gs, Gs, Gg, Ss, Ww^Ewl, Wo, Wo, Wo, Wo, Wwrg, Wo, Re, Rp, Rp, Rp, Rp, Sm, Sm, Gd, Gd
Rrc, Rrc, Aa^Eff, Aa^Eff, Aa, Aa, Aa, Aa, Aa, Rrc, Kha, Kha, Kha, Ai, Aa, Aa, Ai, Ai, Aa, Aa, Gg, Gg, Gg^Dr, Gg, Ss, Gs, Gs, Gs, Wo, Wwrg, Wo, Wo, Ww^Vm, Wo, Ww^Vm, Wo, Wo, Wo, Ww^Ewf, Sm, Sm, Sm, Sm, Gd, Gd, Sm
Ms^Xm, Aa, Aa, Aa, Aa, Aa, Aa, Aa, Aa, Ai, Ai, Kha, Ai, Ai, Aa, Ai, Aa, Aa, Aa, Gg^Dr, Rr, Rr, Gg^Dr, Wwt, Wwt, Wwt, Wwrt, Wo, Wo, Wo, Wo, Chw, Chw, Khw, Wwrg, Chw, Wwrt, Wo, Wo, Wo, Sm, Sm, Sm, Gd, Sm, Sm
Ms^Xm, Ms^Xm, Aa, Aa, Aa, Aa, Aa, Aa, Aa, Aa, Aa, Ai, Aa, Aa, Aa, Aa, Aa, Aa, Aa, Gg^Dr, Rr, Rr, Gg^Dr, Wwt, Wwt, Wwt, Wo, Wo, Ww^Ewf, Wo, Wo, Khw, Chw, Ww^Vm, Wwrg, Ww^Vm, Wo, Wo, Wo, Wwrt, Ss, Ww^Ewl, Ss, Gg^Fet, Sm, Sm
Ms^Xm, Ms^Xm, Ms^Xm, Aa, Aa, Aa, Aa, Aa, Aa, Aa, Aa, Aa, Aa, Aa, Aa, Aa, Aa, Aa, Aa, Gg^Dr, Rr, Rr, Gg^Dr, Wwt, Wwt, Wwt, Wo, Wo, Wo, Wo, Wo, Ww^Vm, Chw, Khw, Ww^Vm, Wwrg, Wo, Wo, Ww^Ewl, Ss, Ww, Wwrt, Ww, Ss, Wwr^Bw/, Gg
Ms^Xm, Ms^Xm, Ms^Xm, Aa^Vla, Aa, Aa, Aa, Aa, Ai, Aa, Aa, Aa, Aa, Aa, Ha, Aa^Fma, Aa^Fma, Aa, Aa, Gg^Dr, Rr, Rr, Gg^Dr, Wwt, Wwt, Wwt, Wwt, Wwrt, Wo, Wwrt, Ww^Ewl, Wo, Wo, Wwrt, Wo, Wwrg, Wwrt, Wo, Ss, Wwrt, Ww, Ww^Ewl, Ww^Bw/, Ww^Bw/, Ss, Gg
Ms^Xm, Ms^Xm, Ms^Xm, Ms^Xm, Ms^Xm, Aa, Aa, Ai, Aa, Ai, Aa, Aa, Aa^Fma, Aa^Fma, Aa^Fpa, Aa^Fda, Aa^Fma, Aa, Aa, Gg^Dr, Rr, Rr, Gg^Dr, Wwt, Ss, Wwt, Wwt, Wwt, Wwt, Wo, Wo, Wwrt, Wo, Wo, Wwr, Wwrg, Wwt, Wwt, Ss, Ww, Ww^Bw/, Ww^Bw/, Ww, Ww, Ss, Gg
Ms^Xm, Ms^Xm, Ms^Xm, Ms^Xm, Ms^Xm, Aa^Vla, Aa, Aa, Aa, Aa, Aa, Aa, Aa^Fma, Aa^Fma, Ha, Aa^Fma, Aa, Aa, Aa, Gg^Dr, Rr, Rr, Gg^Dr, Wwt, Wwt, Wwt, Wwt, Wwt, Ss, Gg, Wwt, Wo, Ww^Ewf, Wo, Wwt, Wwt, Wwt, Wwt, Wwr^Bw/, Ww^Bw/, Ww, Ww^Ewl, Ww, Wwrt, Ww^Ewl, Gg
Ms^Xm, Ms^Xm, Ms^Xm, Ms^Xm, Ms^Xm, Ms^Xm, Ms^Xm, Aa, Aa, Aa, Aa, Aa, Ai, Aa^Fma, Ai, Aa, Ai, Aa, Aa, Gg^Dr, Rr, Rr, Gg^Dr, Wwt, Wwt, Wwt, Wwt, Wwt, Wwt, Wwt, Wwt, Wwt, Wwt, Wwt, Wwt, Wwt, Wwt, Gg, Wwt, Ss, Ss, Wwrt, Ss, Ss, Gd^Wm, Wwt
Ms^Xm, Ms^Xm, Ms^Xm, Ms^Xm, Ms^Xm, Ms^Xm, Ms^Xm, Aa, Aa, Aa, Aa, Aa, Ai, Ai, Aa, Ai, Aa, Ai, Aa, Gg^Dr, Rr, Rr, Gg, Wwt, Wwt, Wwt, Wwt, Wwt, Wwt, Wwt, Gg, Wwt, Wwt, Wwt, Gg, Wwt, Wwt, Wwt, Wwt, Wwt, Gg, Ww^Ewl, Gg, Wwt, Gg, Wwt
